O
*** ********************************************
***                                    *********
***   * ****************************** *********
***   * ****************************** *********
***   * **************     *********** *********
***   * *****************              *********
***   *         ********************************
***   ********   *****************           ***
***            * ****************** ************
************** * ****************** ************
************** *                            ****
****           *************************** *****
**** ********* ************ ************* ******
**** ********* ************           **********
**** ********* ********************** **********
**** ********* ********************** **********
**************                        **********
*************************************         **
                                              S
